1111111111111111111111111111111111111111111111111111111111111111
1000000000000000000000000000000000000000000000000000000000000001
1000000000011110000000000000000000000000000000000000000000000001
1000000000000011000000000000000000000000000000000000000000000001
1000000000000001000000000000000000000000011110000000000000000001
1000000000000000000000000000000000001111100000000000000000000001
1000000000000000000000000000000000000000000000000000000000000001
1000000000000000000000000000000000000000000000000000000000000001
1000000000000000000000000000000000000000000000000000000000000001
1000000000000000000000000000000000111111111000111111110000000001
1000000000000000000000000011111111000000000000000000001000000001
1000000000000000000000000000000000000000000000000000000100000001
1000000000000000000000000000000000000000000000000000011000000001
1000000000000000000000000000000000000000000000111111100000000001
1000000000000000000000000000000011111111111000000000000000000001
1000000000000000000000011111111100000000000000000000000000000001
1000000000000000000000000000000000000000000000000000000000000001
1000000000000000000000000000000000000000000000000000000000000001
1000000000000000000000000000000000000000000000000000000000000001
1000000000000000000000000000000000000000000000000000000000000001
1000000000000000000000000000000000000000000000000000000000000001
1000000000000000000000000000000000011111100000000000000000000001
1000000000000000000000000000011111100000000000000000000000000001
1000000000000000000000000000000000000000000000000000000000000001
1000000000000000000000000000000000000000000000000000100000000001
1000000000000000000000000000000000000000000000000000100000000001
1000000000000000000000010000000000000000000000000001000000000001
1000000000000000000000001000000000000000000000000001000000000001
1000000000000000000000000100000000000000000000000010000000000001
1000000000111111111100000000000000000000000000000010000000000001
1000000000000000000000000011111000000000000000000000000000000001
1000000000000000000000000000000000000000000000000000000000000001
1000000000000000000000000000000000000000000000000000000000000001
1000000000000000000000000000000000000000000000000000000000000001
1000000000000000000000000000000000000000000000000000000000000001
1111111111111111111111111111111111111111111111111111111111111111